0 4 6 7 1 5 2 9 3
9 0 0 0 0 0 4 0 0
0 0 5 0 0 0 0 0 0
7 9 0 4 0 6 0 0 2
4 0 0 0 0 8 7 3 0
0 0 0 2 0 0 0 0 0
2 0 0 5 0 0 6 1 9
0 3 0 0 0 0 0 5 7
0 0 0 0 0 7 3 0 0