5 1 9 8 7 6 3 4 2 
6 4 7 1 2 3 5 9 8
3 8 2 4 9 5 7 1 6
1 6 4 7 3 2 8 5 9
7 9 8 5 1 4 2 6 3
2 5 3 6 8 9 4 7 1
9 7 1 2 4 8 6 3 5
4 2 5 3 6 1 9 8 7
8 3 6 9 5 7 1 2 4