8 4 6 7 1 5 2 9 3
9 1 7 3 8 2 4 6 5
3 2 5 6 9 4 1 7 8
7 9 1 4 3 6 5 8 2
4 6 2 9 5 8 7 3 1
5 8 3 2 7 1 9 4 6
2 7 8 5 4 3 6 1 9
6 3 4 1 2 9 8 5 7
1 5 9 8 6 7 3 2 4