0 0 0 8 7 6 3 4 2 
0 0 0 0 0 0 0 0 0
0 0 0 0 0 5 0 0 0
0 0 0 0 0 2 8 5 9
0 0 8 0 1 0 0 0 3
0 5 3 0 0 0 4 7 0
0 7 0 2 0 8 6 3 0
4 0 0 3 6 1 9 0 0
8 0 0 0 5 0 0 2 0